+p+++++++++++++++++++++++++++++++
|       |       |   |       |   +
+ + +++ + +++++ + +++ + +++++ + +
| |   |   |       |   |   |   | +
+++++ +++ +++++++++ +++++ + +++ +
|   |   | |         | |   | |   +
+ + +++ + + +++++++++ + +++ + +++
| | |   | | | |       |   | |   +
+ + + + +++ + + + +++++++ + +++ +
| |   | |   |   |       | |   | +
+ +++++++ +++++++ +++ +++ +++ + +
|   |     |     |   |   |   | | +
+++ + +++++ +++ +++++++ + +++++ +
|   | |     |   |       |     | +
+ +++ +++++ + +++ +++++ +++ +++ +
|           |     |       |     +
+++++++++++++++++++++++++++++++g+
