+--+--+--+--+--+--+--+--+--+--
|                       |     
+  +--+--+--+  +--+--+  +--+  
|     |     |        |  |     
+--+--+  +  +--+--+  +  +  +  
| p      |     |     |  |  |  
+  +--+--+--+  +  +--+  +  +  
|           |  |  |  |  |  |g 
+  +--+--+  +  +  +  +  +  +  
|     |     |     |        |  
+--+  +  +--+--+--+--+--+--+  
|     |        |     |        
+  +--+--+--+  +  +  +--+--+  
|     |     |     |        |  
+--+  +  +--+--+--+--+--+  +  
|     |                 |  |  
+  +--+  +--+--+--+  +  +  +--
|  |     |        |  |  |     
+  +--+--+  +--+  +  +  +--+--
|     |     |  |  |  |  |     
+--+  +  +--+  +  +  +  +  +  
|      |         |   ||
