+--+--+--+--+--+--+--+--+--+--
|     |     |                 
+  +  +  +  +--+--+--+--+--+  
|  |     |                    
+  +--+--+--+--+--+--+--+--+  
|        |     |     g     |  
+  +--+  +  +  +  +  +--+--+  
|     | p|  |     |  |     |  
+--+--+  +  +--+--+--+  +  +  
|        |              |     
+  +--+--+  +--+--+--+--+--+--
|  |                          
+  +--+--+--+--+--+--+--+--+--
|     |              |        
+--+  +  +--+--+--+  +  +--+  
|     |           |  |  |     
+  +--+--+--+--+  +  +  +  +--
|        |        |     |  |  
+  +  +--+--+--+--+--+--+  +  
|  |                          
+--+--+--+--+--+--+--+--+--+--
|||||||||||
